NO ./textures/bluestone.xpm
EA ./textures/colorstone.xpm
WE ./textures/wood.xpm
SO ./textures/redbrick.xpm

C 110,153,15
F 255,255,255

         111111111111111111111111
        1000000000000000000000001
        1000000000000000000000001
        1000000000000000000000001
111111111000000000000000000000001
100000000000000000000000000001111
10000000000000000000000000001
10000000000000000000000000001
10000000000000000000000111111
10000000000000000000000100001
10000000000000000001010100E01
11000001110101011111011110101
11110111 1110101 101111010001
11111111 1111111 111111111111
