NO ./textures/bluestone.xpm
EA ./textures/colorstone.xpm
SO ./textures/redbrick.xpm
WE ./textures/wood.xpm

C 1,1,1
F 184,113,39



111111       111111111111          
100001       100000000001
100001       100000000001
1000011111111100000010001
1000000000000000000010001
1000000000000000011110001
1000000000000000000010001
1000000000000000000010001
1000000000000000000010001
100000000000E000000010001
1000000000000000000000001
1000000000000000101000001
1111111111111111111111111
1111110001111111111111111
1111111111111111111111111
