NO textures/no_wall.xpm
SO textures/so_wall.xpm
WE textures/we_wall.xpm
EA textures/ea_wall.xpm

F 184,113,39
C 51,198,227

1111111111111111111111111
1000000100000000000000001
1011000001110000000000001
1000000000000000000010001
1011000001110000000010001
1000001100000111011110001
1111011111011100000010001
1000011111011101010010001
1100011010101110000010001
10000000000011000N0010001
1100000011010100000000001
1111011111010000101000001
1000001100000100000010001
