NO ./textures/bluestone.xpm
EA ./textures/colorstone.xpm
WE ./textures/wood.xpm
SO ./textures/redbrick.xpm

C 110,153,15
F 255,255,255

         111111111111111111111111111
         100000000000000000000000001
         100000000000000000000000001
         100000001000000000000000001
111111111100000000000000000000000001
1000000000000000E0000000000011111111
10000000000000000000000000001
10000000000000000000000000001
10000000000000000000000000001
10000000000000000000000000001
10000000000000000000000000001
11111111110000000000000000001
11110110110111110000000000001
11111111111111111111111111111
