NO textures/no_wall.xpm
SO textures/so_wall.xpm
WE textures/we_wall.xpm
EA textures/ea_wall.xpm

F 184,113,39
C 51,198,227

11111111111111   11111111          
10000001000001   10000001
10110100011101   10000001
1000000000000111110000001
1011000001110000000010001
1000001100000111011110001
1111011111011100000010001
1000011111011101010010001
1111111111111110000010001
            11000N0010001
            1100000000001
            1000101000001
            1111111111111
