NO ./textures/bluestone.xpm
SO ./textures/redbrick.xpm
WE ./textures/wood.xpm
EA ./textures/colorstone.xpm

F 184,113,39
C 1,1,1

1111111111111111111111111          
1000000000001111110000001
1000000000000000000000001
1000000000000000000010001
1000000000000000000010001
1000000000000000011110001
1000000000000000000010001
1000000000000000000010001
1000000000000000000010001
100000000000E000000010001
1000000000000000000000001
1000000000000000101000001
1111111111111111111111111
